000000000000000-
001111100000000-
001100100000000-
001111100000000-
001110000000000-
001101000000000-
001100100000000-
000000000000000-
000000000000000-
000000000000000-
000000000002220